{
	"width": 20,
	"height": 20,
	"block_width": 16,
	"block_height": 16,
	"sprites": [
		0,
		"sandfull",
		"sandbottom0",
		"sandbottom1",
		"wallsand",
		"door0",
		"door1",
		"sandleft1",
		"sea",
		"wave0",
		"rock2",
		"sandright0",
		"sandleft0",
		"rock1",
		"wave3",
		"sandright1",
		"rock0",
		"wave1",
		"wave2",
		"sandtop0",
		"sandtop1",
		"wall1",
		"wall0"
	],
	"data": [
		1, 2, 2, 3, 2, 3, 2, 4, 5, 5, 6, 6, 4, 2, 2, 3, 2, 3, 2, 1, 7, 8, 8, 8, 8, 9, 8, 8, 8, 8, 8, 8, 8, 8, 8, 8, 8, 10, 8, 11, 12, 8, 8, 13, 8, 8, 8, 8, 8, 8, 8,
		14, 8, 8, 8, 8, 8, 8, 8, 11, 12, 8, 8, 8, 8, 8, 8, 8, 8, 8, 8, 8, 8, 8, 8, 9, 8, 8, 8, 15, 7, 8, 8, 8, 8, 8, 8, 9, 8, 8, 16, 8, 8, 8, 8, 8, 17, 8, 8, 11, 7,
		8, 8, 17, 8, 8, 8, 8, 8, 9, 8, 9, 8, 8, 8, 8, 8, 8, 8, 11, 12, 8, 8, 8, 8, 8, 8, 8, 8, 8, 8, 8, 14, 8, 8, 8, 8, 8, 8, 15, 12, 8, 8, 8, 8, 8, 8, 8, 8, 8, 8, 9,
		8, 8, 8, 8, 8, 8, 8, 11, 12, 8, 8, 16, 8, 9, 8, 8, 8, 8, 8, 13, 8, 9, 8, 9, 16, 8, 8, 11, 12, 8, 8, 8, 8, 8, 8, 8, 8, 9, 8, 8, 8, 8, 8, 8, 8, 8, 8, 15, 12, 9,
		8, 8, 8, 8, 8, 8, 8, 8, 8, 8, 8, 8, 8, 18, 8, 8, 8, 11, 12, 8, 8, 8, 8, 8, 8, 16, 8, 8, 8, 8, 8, 8, 8, 8, 8, 8, 8, 11, 12, 8, 8, 17, 8, 8, 8, 9, 8, 8, 8, 9,
		8, 8, 8, 8, 8, 8, 8, 11, 7, 9, 8, 8, 8, 8, 8, 8, 8, 8, 8, 8, 8, 8, 8, 8, 16, 8, 8, 11, 12, 8, 8, 8, 8, 9, 8, 14, 9, 8, 8, 8, 8, 17, 8, 8, 8, 8, 8, 11, 7, 8,
		8, 8, 8, 8, 8, 8, 8, 8, 8, 13, 8, 8, 8, 8, 8, 8, 8, 15, 12, 8, 10, 8, 8, 8, 8, 9, 8, 8, 8, 8, 8, 8, 8, 9, 8, 8, 8, 11, 12, 8, 9, 8, 8, 8, 9, 8, 8, 8, 8, 8, 8,
		8, 8, 8, 8, 8, 8, 11, 12, 8, 8, 8, 8, 8, 8, 8, 8, 8, 8, 8, 8, 8, 8, 8, 8, 10, 8, 11, 1, 19, 19, 20, 19, 20, 19, 21, 5, 6, 6, 5, 22, 19, 19, 20, 19, 20, 19, 1
	]
}
