{
	"width": 20,
	"height": 20,
	"block_width": 16,
	"block_height": 16,
	"sprites": [
		0,
		"sandfull",
		"sandbottom0",
		"sandbottom1",
		"wallsand",
		"door0",
		"door1",
		"sandleft0",
		"sea",
		"sandright0",
		"sandleft1",
		"wave4",
		"wave1",
		"sandright1",
		"rock0",
		"wave0",
		"wave3",
		"wave2",
		"sandtop0",
		"sandtopleft1",
		"sandtopright0",
		"sandtopleft0",
		"sandleftbottom0",
		"sandbottomright0",
		"sandbottomright1",
		"sandleftbottom1",
		"sandtopright1",
		"sandtop1",
		"wall1",
		"wall0"
	],
	"data": [
		1, 2, 3, 3, 3, 2, 2, 4, 5, 5, 6, 6, 4, 2, 2, 3, 3, 2, 2, 1, 7, 8, 8, 8, 8, 8, 8, 8, 8, 8, 8, 8, 8, 8, 8, 8, 8, 8, 8, 9, 10, 8, 8, 8, 11, 8, 8, 8, 8, 12, 8, 8,
		8, 8, 8, 8, 12, 8, 8, 13, 10, 8, 14, 8, 8, 8, 8, 8, 8, 8, 8, 8, 8, 8, 8, 8, 8, 8, 8, 13, 10, 8, 8, 8, 15, 8, 8, 14, 8, 8, 16, 8, 14, 16, 8, 8, 8, 8, 8, 9, 10,
		8, 16, 8, 8, 11, 8, 8, 8, 8, 8, 8, 8, 14, 8, 8, 8, 17, 8, 13, 7, 8, 8, 8, 8, 8, 8, 8, 8, 12, 8, 8, 8, 8, 8, 8, 8, 8, 8, 9, 1, 18, 18, 19, 8, 8, 20, 18, 18,
		21, 20, 18, 18, 19, 8, 8, 20, 18, 18, 1, 1, 2, 2, 22, 8, 8, 23, 2, 3, 22, 24, 3, 3, 25, 8, 14, 24, 3, 2, 1, 7, 14, 8, 8, 8, 8, 8, 14, 8, 17, 8, 8, 8, 8, 8, 8,
		8, 8, 14, 9, 7, 8, 11, 8, 14, 17, 8, 8, 8, 8, 8, 14, 8, 8, 12, 8, 8, 8, 8, 9, 1, 18, 18, 21, 8, 8, 26, 18, 18, 21, 20, 18, 18, 21, 8, 8, 20, 18, 18, 1, 1, 2,
		2, 25, 8, 8, 24, 3, 2, 22, 23, 2, 3, 22, 8, 8, 24, 2, 2, 1, 7, 8, 8, 8, 8, 8, 8, 11, 8, 8, 8, 8, 8, 8, 8, 8, 8, 8, 8, 9, 7, 8, 16, 8, 15, 8, 8, 8, 8, 8, 8,
		15, 8, 16, 8, 8, 8, 14, 8, 9, 10, 8, 8, 8, 8, 8, 8, 11, 8, 8, 8, 8, 8, 8, 8, 8, 8, 8, 8, 13, 10, 8, 8, 8, 17, 8, 8, 8, 8, 8, 17, 8, 8, 8, 14, 8, 8, 8, 8, 13,
		7, 8, 8, 14, 8, 8, 15, 8, 8, 8, 8, 8, 15, 8, 8, 14, 8, 12, 8, 9, 7, 8, 8, 8, 8, 8, 8, 8, 8, 8, 8, 8, 8, 8, 8, 8, 8, 8, 8, 9, 1, 18, 18, 27, 27, 18, 18, 28, 5,
		6, 6, 5, 29, 18, 18, 27, 27, 27, 18, 1
	]
}
