{
	"width": 20,
	"height": 20,
	"block_width": 16,
	"block_height": 16,
	"sprites": [
		0,
		"sandfull",
		"sandbottom0",
		"wallsand",
		"door1",
		"door0",
		"sandleft0",
		"sea",
		"wave1",
		"wave4",
		"sandright0",
		"sandleft1",
		"wave2",
		"wave3",
		"sandright1",
		"rock2",
		"rock0",
		"rock1",
		"wave0",
		"sandtop0",
		"wall0",
		"wall1",
		"sandtop1"
	],
	"data": [
		1, 1, 1, 1, 1, 2, 2, 3, 4, 5, 4, 5, 3, 2, 2, 1, 1, 1, 1, 1, 1, 1, 1, 1, 6, 7, 7, 7, 8, 7, 7, 7, 7, 9, 7, 10, 1, 1, 1, 1, 1, 1, 1, 1, 11, 7, 7, 12, 7, 7, 13,
		7, 7, 7, 7, 14, 1, 1, 1, 1, 1, 1, 1, 1, 11, 7, 7, 7, 7, 7, 7, 7, 7, 12, 7, 14, 1, 1, 1, 1, 1, 1, 1, 1, 11, 15, 15, 16, 17, 16, 7, 7, 7, 8, 7, 10, 1, 1, 1, 1,
		1, 1, 1, 1, 6, 7, 7, 7, 7, 7, 7, 7, 7, 7, 7, 14, 1, 1, 1, 1, 1, 1, 1, 1, 11, 7, 8, 7, 9, 7, 12, 7, 7, 9, 7, 10, 1, 1, 1, 1, 1, 1, 1, 1, 6, 7, 13, 7, 7, 7, 7,
		7, 7, 7, 7, 10, 1, 1, 1, 1, 1, 1, 1, 1, 11, 7, 7, 7, 7, 7, 16, 15, 17, 16, 16, 10, 1, 1, 1, 1, 1, 1, 1, 1, 11, 7, 7, 7, 18, 7, 7, 7, 7, 7, 7, 10, 1, 1, 1, 1,
		1, 1, 1, 1, 6, 7, 7, 12, 7, 7, 7, 18, 7, 7, 7, 14, 1, 1, 1, 1, 1, 1, 1, 1, 6, 7, 7, 7, 7, 7, 7, 7, 7, 7, 12, 14, 1, 1, 1, 1, 1, 1, 1, 1, 11, 15, 17, 15, 16,
		16, 7, 7, 7, 13, 7, 10, 1, 1, 1, 1, 1, 1, 1, 1, 6, 7, 7, 7, 7, 7, 7, 9, 7, 7, 7, 14, 1, 1, 1, 1, 1, 1, 1, 1, 11, 7, 7, 7, 18, 7, 7, 8, 7, 18, 7, 14, 1, 1, 1,
		1, 1, 1, 1, 1, 6, 13, 7, 7, 7, 7, 7, 7, 7, 7, 7, 10, 1, 1, 1, 1, 1, 1, 1, 1, 11, 7, 7, 7, 7, 7, 16, 17, 16, 17, 15, 10, 1, 1, 1, 1, 1, 1, 1, 1, 11, 7, 18, 7,
		7, 8, 7, 7, 7, 7, 7, 10, 1, 1, 1, 1, 1, 1, 1, 1, 6, 7, 7, 7, 7, 7, 7, 7, 7, 7, 9, 10, 1, 1, 1, 1, 1, 1, 1, 1, 1, 19, 19, 20, 5, 4, 4, 5, 21, 22, 19, 1, 1, 1,
		1, 1
	]
}
