{
      "width": 20,
      "height": 20,
      "block_width": 16,
      "block_height": 16,
      "sprites": [
            0,
            "sandfull",
            "sandbottom0",
            "sandbottom1",
            "wallsand",
            "door0",
            "door1",
            "sandleft1",
            "sea",
            "sandright0",
            "sandleft0",
            "wave1",
            "wave3",
            "wave0",
            "sandright1",
            "sandbottomright1",
            "sandleftbottom0",
            "rock0",
            "rock2",
            "wave2",
            "sandtopright0",
            "sandtopleft1",
            "sandtop0",
            "sandtop1",
            "wall1",
            "wall0"
      ],
      "data": [
            1, 2, 2, 3, 2, 1, 1, 4, 5, 5, 6, 6, 4, 1, 1, 3, 2, 3, 2, 1, 7, 8, 8, 8, 8, 9, 10, 8, 8, 8, 8, 8, 8, 9, 10,
            8, 8, 8, 8, 9, 10, 8, 11, 8, 8, 9, 10, 8, 8, 8, 8, 12, 8, 9, 10, 8, 8, 8, 8, 9, 10, 8, 8, 8, 8, 9, 10, 8, 8,
            8, 8, 8, 8, 9, 10, 13, 8, 8, 8, 14, 7, 8, 8, 8, 8, 9, 10, 13, 8, 8, 8, 8, 8, 9, 10, 8, 11, 8, 8, 9, 7, 8, 8,
            11, 8, 9, 10, 8, 8, 13, 8, 13, 8, 9, 10, 8, 8, 8, 8, 9, 10, 8, 8, 8, 8, 15, 16, 8, 8, 8, 8, 8, 12, 15, 16,
            8, 8, 8, 8, 14, 10, 8, 8, 8, 8, 8, 8, 8, 8, 8, 8, 13, 8, 8, 8, 8, 17, 8, 8, 9, 10, 8, 11, 8, 8, 13, 8, 8, 8,
            17, 8, 8, 8, 13, 8, 8, 8, 8, 8, 9, 10, 8, 8, 8, 8, 8, 8, 8, 17, 17, 18, 8, 8, 8, 8, 8, 8, 8, 8, 14, 10, 13,
            8, 8, 8, 8, 8, 8, 8, 18, 18, 18, 8, 8, 8, 19, 8, 8, 8, 9, 10, 8, 8, 8, 8, 8, 8, 8, 8, 8, 18, 8, 8, 8, 8, 8,
            8, 8, 11, 9, 10, 8, 8, 11, 8, 8, 8, 13, 8, 8, 8, 13, 8, 8, 8, 8, 8, 8, 8, 9, 7, 13, 8, 17, 8, 20, 21, 8, 8,
            8, 8, 8, 8, 20, 21, 8, 11, 8, 8, 9, 10, 8, 8, 8, 8, 9, 10, 12, 13, 8, 8, 11, 8, 9, 10, 8, 8, 8, 8, 9, 7, 8,
            8, 8, 11, 9, 10, 8, 8, 8, 8, 8, 8, 9, 10, 8, 8, 8, 8, 14, 10, 8, 8, 8, 8, 9, 10, 13, 8, 11, 8, 8, 8, 9, 10,
            13, 8, 8, 8, 9, 10, 8, 13, 8, 8, 9, 10, 8, 8, 8, 8, 11, 8, 9, 10, 8, 8, 11, 8, 9, 10, 8, 8, 8, 8, 9, 10, 8,
            8, 8, 8, 8, 8, 9, 10, 8, 8, 8, 8, 9, 1, 22, 22, 23, 22, 1, 1, 24, 5, 6, 6, 5, 25, 1, 1, 23, 22, 23, 22, 1
      ]
}
