{
	"width": 20,
	"height": 20,
	"block_width": 16,
	"block_height": 16,
	"sprites": [
		0,
		"sandfull",
		"sandbottom0",
		"sandbottom1",
		"wallsand",
		"door0",
		"door1",
		"sandleft1",
		"sea",
		"wave0",
		"sandright0",
		"sandleft0",
		"wave3",
		"sandtopright0",
		"sandtopleft1",
		"sandtop0",
		"sandright1",
		"sandbottomright1",
		"sandleftbottom1",
		"wave1",
		"rock0",
		"sandtop1",
		"wall1",
		"wall0"
	],
	"data": [
		1, 2, 2, 3, 2, 3, 2, 4, 5, 5, 6, 6, 4, 2, 2, 3, 2, 3, 2, 1, 7, 8, 8, 8, 8, 9, 8, 8, 8, 8, 8, 8, 8, 8, 8, 8, 8, 8, 8, 10, 11, 8, 8, 8, 8, 8, 8, 8, 8, 8, 8, 12,
		8, 8, 8, 8, 8, 8, 8, 10, 11, 8, 8, 13, 14, 8, 8, 13, 15, 15, 15, 15, 15, 15, 15, 15, 14, 8, 8, 16, 7, 8, 8, 10, 7, 8, 8, 17, 3, 3, 3, 3, 3, 3, 3, 1, 7, 8, 8,
		10, 7, 8, 8, 10, 7, 8, 8, 8, 8, 8, 8, 8, 8, 8, 8, 10, 7, 8, 8, 10, 11, 8, 8, 10, 7, 8, 8, 8, 8, 8, 8, 8, 12, 8, 8, 10, 7, 8, 8, 16, 11, 8, 8, 10, 1, 15, 15,
		15, 15, 15, 15, 15, 14, 8, 8, 10, 7, 8, 8, 10, 11, 8, 8, 10, 1, 3, 3, 3, 3, 3, 3, 3, 18, 9, 8, 10, 7, 8, 8, 10, 11, 8, 8, 10, 7, 8, 8, 8, 8, 8, 8, 8, 8, 8, 8,
		10, 7, 8, 8, 16, 11, 9, 8, 10, 7, 8, 8, 8, 8, 8, 8, 8, 8, 8, 8, 10, 7, 8, 8, 10, 11, 8, 8, 10, 7, 8, 8, 13, 15, 15, 15, 15, 15, 15, 15, 1, 1, 15, 15, 1, 11,
		8, 8, 10, 7, 8, 8, 17, 3, 3, 3, 3, 3, 3, 3, 3, 3, 3, 3, 1, 7, 9, 8, 10, 7, 8, 8, 8, 8, 8, 8, 8, 8, 8, 8, 8, 8, 8, 8, 16, 11, 8, 8, 10, 7, 8, 8, 12, 8, 8, 8,
		8, 8, 19, 8, 8, 8, 8, 8, 10, 7, 8, 8, 10, 1, 15, 15, 15, 15, 15, 15, 15, 15, 15, 14, 8, 8, 8, 8, 16, 11, 8, 8, 17, 3, 3, 3, 3, 3, 3, 3, 3, 3, 1, 7, 9, 20, 20,
		8, 10, 11, 8, 9, 8, 8, 8, 9, 8, 8, 8, 8, 8, 8, 16, 7, 8, 8, 8, 8, 10, 11, 8, 8, 8, 8, 8, 8, 8, 8, 8, 8, 8, 8, 16, 7, 8, 8, 8, 8, 10, 1, 15, 15, 21, 15, 21,
		15, 22, 5, 6, 6, 5, 23, 1, 1, 21, 15, 21, 15, 1
	]
}
