{
      "width": 20,
      "height": 20,
      "block_width": 16,
      "block_height": 16,
      "sprites": [
            0,
            "sandfull",
            "sandbottom0",
            "sandbottom1",
            "wallsand",
            "door0",
            "door1",
            "sandleft1",
            "sea",
            "wave0",
            "sandright0",
            "sandleft0",
            "wave1",
            "wave3",
            "rock2",
            "sandright1",
            "sandtopright0",
            "sandtopleft1",
            "sandbottomright1",
            "sandleftbottom1",
            "sandtop0",
            "sandtop1",
            "wall1",
            "wall0"
      ],
      "data": [
            1, 2, 2, 3, 2, 3, 2, 4, 5, 5, 6, 6, 4, 2, 2, 3, 2, 3, 2, 1, 7, 8, 8, 8, 8, 9, 8, 8, 8, 8, 8, 8, 8, 8, 8, 8,
            8, 8, 8, 10, 11, 8, 8, 12, 8, 8, 8, 8, 8, 8, 8, 13, 8, 8, 8, 8, 8, 12, 8, 10, 11, 8, 8, 14, 14, 8, 8, 8, 8,
            8, 8, 8, 8, 8, 8, 14, 14, 8, 8, 15, 7, 8, 8, 14, 8, 8, 8, 9, 8, 16, 17, 8, 8, 8, 8, 8, 14, 8, 8, 10, 7, 8,
            8, 12, 8, 8, 8, 8, 16, 1, 1, 17, 8, 8, 8, 8, 8, 8, 8, 10, 11, 8, 8, 8, 8, 8, 8, 16, 1, 1, 1, 1, 17, 8, 8, 8,
            8, 8, 8, 15, 11, 8, 8, 8, 8, 8, 16, 1, 1, 1, 1, 1, 1, 17, 8, 8, 8, 12, 8, 10, 11, 8, 12, 8, 8, 16, 1, 1, 1,
            1, 1, 1, 1, 1, 17, 9, 8, 8, 8, 10, 11, 8, 8, 8, 16, 1, 1, 1, 1, 1, 1, 1, 1, 1, 1, 17, 8, 8, 8, 15, 11, 9, 8,
            8, 18, 1, 1, 1, 1, 1, 1, 1, 1, 1, 1, 19, 8, 8, 8, 10, 11, 8, 8, 8, 8, 18, 1, 1, 1, 1, 1, 1, 1, 1, 19, 8, 8,
            8, 8, 10, 11, 8, 8, 12, 8, 8, 18, 1, 1, 1, 1, 1, 1, 19, 8, 8, 8, 8, 8, 10, 7, 9, 8, 8, 8, 8, 8, 18, 1, 1, 1,
            1, 19, 8, 8, 8, 8, 12, 8, 10, 11, 8, 8, 8, 8, 9, 8, 13, 18, 1, 1, 19, 8, 12, 8, 8, 8, 8, 8, 10, 7, 8, 8, 14,
            8, 8, 8, 8, 8, 18, 19, 8, 8, 8, 8, 8, 14, 8, 8, 15, 11, 8, 8, 14, 14, 8, 8, 9, 8, 8, 8, 8, 8, 8, 8, 14, 14,
            12, 8, 10, 11, 8, 9, 8, 8, 8, 9, 8, 8, 8, 8, 8, 12, 8, 8, 8, 8, 8, 8, 10, 11, 8, 8, 8, 8, 8, 8, 8, 8, 8, 8,
            8, 8, 8, 8, 8, 8, 8, 8, 10, 1, 20, 20, 21, 20, 21, 20, 22, 5, 6, 6, 5, 23, 20, 20, 21, 20, 21, 20, 1
      ]
}
