{
	"width": 20,
	"height": 20,
	"block_width": 16,
	"block_height": 16,
	"sprites": [
		0,
		"sandfull",
		"wallsand",
		"door0",
		"door1",
		"sandleftbottom1",
		"sea",
		"sandright1",
		"sandtopright1",
		"sandbottom0",
		"wave0",
		"sandbottomright1",
		"sandbottom1",
		"sandleft0",
		"sandright0",
		"sandtop1",
		"sandtopleft1",
		"sandtopright0",
		"rock1"
	],
	"data": [
		1, 1, 1, 1, 1, 1, 1, 2, 3, 3, 4, 4, 2, 1, 1, 1, 1, 1, 1, 1, 1, 1, 1, 1, 1, 1, 1, 5, 6, 6, 6, 6, 7, 1, 1, 1, 1, 1, 1, 1, 1, 1, 1, 1, 1, 1, 5, 6, 6, 6, 6, 8, 1,
		1, 1, 1, 1, 1, 1, 1, 1, 1, 1, 1, 1, 5, 6, 6, 6, 6, 8, 1, 1, 1, 1, 1, 1, 1, 1, 1, 1, 9, 9, 9, 5, 6, 6, 10, 6, 6, 11, 12, 12, 12, 12, 12, 12, 12, 12, 1, 13, 6,
		6, 6, 6, 6, 6, 6, 6, 6, 6, 6, 6, 6, 6, 6, 6, 6, 6, 14, 13, 6, 6, 6, 6, 6, 6, 6, 6, 6, 6, 6, 6, 6, 6, 6, 6, 6, 6, 14, 13, 6, 6, 6, 6, 6, 6, 6, 6, 6, 6, 6, 6,
		6, 6, 6, 6, 6, 6, 14, 1, 15, 15, 15, 16, 10, 6, 6, 6, 6, 17, 15, 15, 15, 15, 15, 15, 15, 15, 1, 1, 1, 1, 1, 1, 16, 6, 6, 6, 10, 11, 1, 1, 1, 1, 1, 1, 1, 1, 1,
		1, 1, 1, 1, 1, 1, 16, 6, 6, 6, 6, 11, 1, 1, 1, 1, 1, 1, 1, 1, 1, 1, 1, 1, 1, 1, 1, 16, 6, 6, 6, 6, 11, 1, 1, 1, 1, 1, 1, 1, 1, 9, 9, 9, 9, 9, 9, 5, 6, 6, 6,
		10, 6, 11, 9, 9, 9, 9, 9, 1, 13, 6, 6, 6, 6, 6, 6, 6, 6, 6, 6, 6, 6, 6, 6, 6, 6, 6, 6, 14, 13, 6, 6, 6, 6, 6, 6, 6, 6, 6, 6, 6, 6, 6, 6, 6, 6, 6, 6, 14, 13,
		6, 6, 6, 6, 6, 6, 6, 6, 6, 6, 18, 6, 6, 6, 6, 6, 6, 6, 14, 1, 15, 15, 15, 15, 15, 15, 15, 16, 6, 6, 6, 6, 6, 17, 15, 15, 15, 15, 1, 1, 1, 1, 1, 1, 1, 1, 1, 5,
		6, 6, 6, 6, 17, 1, 1, 1, 1, 1, 1, 1, 1, 1, 1, 1, 1, 1, 13, 6, 6, 6, 6, 17, 1, 1, 1, 1, 1, 1, 1, 1, 1, 1, 1, 1, 1, 1, 2, 3, 4, 4, 3, 2, 1, 1, 1, 1, 1, 1, 1
	]
}
