{
	"width": 20,
	"height": 20,
	"block_width": 16,
	"block_height": 16,
	"sprites": [
		0,
		"sandfull",
		"sandbottom0",
		"sandbottom1",
		"wallsand",
		"door0",
		"door1",
		"sandleft0",
		"sea",
		"wave3",
		"wave2",
		"sandright0",
		"wave0",
		"rock2",
		"wave1",
		"wave4",
		"rock0",
		"sandleft1",
		"sandright1",
		"rock1",
		"sandtopright0",
		"sandtopleft1",
		"sandtopleft0",
		"sandtop1",
		"sandbottomright1",
		"sandleftbottom0",
		"sandtop0",
		"wall0",
		"wall1"
	],
	"data": [
		1, 2, 3, 3, 3, 2, 2, 4, 5, 5, 6, 6, 4, 2, 2, 3, 3, 2, 2, 1, 7, 8, 9, 8, 8,
		8, 8, 8, 8, 8, 8, 8, 8, 8, 8, 8, 8, 10, 8, 11, 7, 8, 8, 8, 12, 8, 8, 12, 8,
		8, 8, 8, 8, 12, 8, 8, 8, 8, 8, 11, 7, 8, 13, 8, 8, 8, 8, 8, 8, 8, 8, 14, 8,
		8, 8, 15, 8, 16, 8, 11, 17, 8, 8, 8, 8, 8, 15, 8, 8, 8, 8, 8, 8, 8, 8, 8, 8,
		8, 8, 18, 7, 8, 8, 9, 8, 13, 8, 8, 8, 13, 8, 8, 8, 8, 16, 8, 8, 8, 8, 11,
		17, 8, 8, 8, 8, 8, 8, 8, 8, 8, 8, 8, 19, 8, 8, 8, 8, 14, 8, 18, 7, 8, 8, 10,
		8, 8, 19, 20, 21, 8, 8, 20, 22, 8, 8, 8, 8, 8, 8, 11, 7, 8, 8, 8, 8, 8, 8,
		11, 7, 8, 8, 18, 7, 8, 19, 8, 8, 12, 8, 11, 7, 8, 8, 8, 12, 8, 8, 11, 7, 8,
		10, 18, 7, 8, 10, 8, 8, 8, 8, 11, 7, 8, 15, 8, 8, 8, 16, 11, 7, 14, 8, 18,
		7, 8, 8, 15, 8, 8, 8, 11, 17, 8, 8, 8, 15, 8, 8, 11, 1, 23, 23, 1, 7, 13, 8,
		8, 8, 14, 8, 18, 7, 8, 14, 8, 8, 8, 8, 24, 3, 2, 3, 3, 25, 8, 8, 8, 8, 9, 8,
		11, 7, 8, 8, 8, 8, 19, 8, 8, 19, 8, 8, 8, 8, 8, 19, 8, 8, 8, 8, 11, 7, 8, 8,
		9, 8, 8, 8, 15, 8, 8, 8, 14, 8, 8, 8, 8, 8, 10, 8, 11, 7, 8, 8, 8, 8, 8, 8,
		8, 8, 8, 8, 8, 8, 8, 8, 8, 8, 8, 8, 11, 17, 8, 8, 13, 8, 8, 8, 12, 8, 8, 8,
		8, 12, 8, 8, 16, 8, 8, 8, 18, 17, 8, 8, 8, 8, 8, 8, 8, 8, 9, 8, 8, 8, 8, 9,
		8, 8, 14, 8, 11, 7, 8, 8, 10, 8, 8, 8, 8, 8, 8, 8, 8, 8, 8, 8, 8, 8, 8, 8,
		11, 1, 26, 26, 23, 23, 26, 26, 27, 5, 6, 6, 5, 28, 26, 26, 26, 23, 23, 26, 1
	]
}
